SO ./wall_texters/N.xpm
        
WE  ./wall_texters/N.xpm

EA ./wall_texters/N.xpm

NO ./wall_texters/N.xpm

F 220,100,0

C 220,100,50

        1111111111111111111111111
        1000000000110000000000001
        1011000001110000000000001
        1001000000000000000000001
111111110011000001110000000000001
10000000011000001110111111111111
11110111111111011100000010001
111C0011  1111011101010010001
11000000110101011100000010001
1000000000000001100000010001
10000E00000000000110101001001
11000001110001011111011110011
11110111 1110101 101111010001
11111111 1111111 111111111111