SO ./wall_texters/N.xpm
        
WE  ./wall_texters/N.xpm

EA ./wall_texters/N.xpm

NO ./wall_texters/N.xpm

F 220,100,0

C 220,100,50

1111111111111111111111111
1000010000110000000000001
10000100001111O111O1100001
1001EC00000000000000O0011
1000011000110000000010001
101100000111000000001001
1001000000000001000000001
1111111111111111111111111
