SO ./wall_texters/N.xpm
        
WE  ./wall_texters/N.xpm

EA ./wall_texters/N.xpm

NO ./wall_texters/N.xpm

C  105,65,192

F  17,17,40

1111111111111111111111111
1000010000110000000000001
10111100001111C111O100001
1100C00000000000000C0011
1011111000110000000100001
1000010000110000000000001
10111100001111C111O100001
1100C00000000000000C0011
1011111000110000000100001
101100000111000N00001001
1001000000000001000000001
1111111111111111111111111
