SO ./wall_texters/S.xpm
        
WE  ./wall_texters/W.xpm

EA ./wall_texters/E.xpm

NO ./wall_texters/N.xpm

F 220,100,0

C 220,100,50


11111111111111111
100000000000000001
1000000000000N0001
111111111111111111