SO ./wall_texters/N.xpm
        
WE  ./wall_texters/N.xpm

EA ./wall_texters/N.xpm

NO ./wall_texters/N.xpm

F 220,100,0

C 220,100,50

1111111111111111111111111
1000010000110000000000001
1000000000110111100000001
1001100000110000000001001
1000011000110011100000001
1011000001110000000001001
100100000000000100N000001
1111111111111111111111111
