SO ./wall_texters/N.xpm
        
WE  ./wall_texters/N.xpm

EA ./wall_texters/N.xpm

NO ./wall_texters/N.xpm

F 220,100,0

C 220,100,50

1111111111111111111111111
1000010000110000000000001
10111100001111C111O100001
1100C00000000000000C0011
1011111000110000000100001
101100000111000000001001
100100000000000100N000001
1111111111111111111111111
