    SO ./wall_texters/N.xpm

     WE ./wall_texters/N.xpm

  EA   ./wall_texters/N.xpm

 NO ./wall_texters/N.xpm

C  105,65,192

F  17,17,40

11111111111 11111111111111                   
10000100001 1000000000111
10111100001111C111O100001
1100C00000000000000C0011
10111110001100000001000011
11     1C000N0000000000C0011
10111110001100000001000011
101100000111000000001001
100100000000001000000001
11111111111111111111111
111111111111 11111111111

