SO ./twacha/wall.xpm
        
WE  ./twacha/wall.xpm

EA ./twacha/wall.xpm

NO ./twacha/wall.xpm

F 220,100,0

C 220,100,50




11111111111111111111111111111111111111111111111111111
10000000000000000000100000000000000000000000000000001
10000000000000000000000010000000000000000000000000001
10000000000000000001000100000000100000000000000000001
10000000000100000000000000001000000000000000000000001
100000000000000000000N0000000000100000000000000000001
10000000000000000000000000000000000000000000000000001
10000000001000001000000000001000000000000000000000001
10000000000000000000000000000000000000000000000000001
10000000000000001000000000000000000000000000000000001
11111111111111111111111111111111111111111111111111111


