SO ./cub3d.c     
        
WE  ./cub3d.c

EA ./cub3d.c

NO ./cub3d.c

F 220,100,0

C 220,100,50




1111111111111
1000000000011
1010000000001
101000N000001
1010000000001
1010000000001
1111111111001
1111111111111


