SO ./cub3d.c    
        
WE  ./cub3d.c

EA ./cub3d.c

NO ./cub3d.c

F 220,100,0

C 220,100,50




1111111111111111111111111
1000000000110000000000001
1011000001110000000000001
10010000000000000000000011111111
111111111011000001110000000000001
100000000011000001110111111111111
11110111111111011100000010001
11110111111111011101010010001
11000000110101011100000010001
10000000000000001100000010001
100000000000000W1101010010001
1N0000011101010111110111100111
11110111 110101 101111010001
11111111 1111111 111111111111


