SO ./cub3d.c     
        
WE  ./cub3d.c

EA ./cub3d.c

NO ./cub3d.c

F 220,100,0

C 220,100,50




11111111111111111111111111111111111111111111111111111
10000000000000000000100000000000000000000000000000001
10000000000000000000000010000000000000000000000000001
10000000000000000001000100000000000000000000000000001
10000000000000000000000000000000000000000000000000001
10000000000000000000S00000000000000000000000000000001
10000000000000000000000000000000000000000000000000001
10000000000000000000000000000000000000000000000000001
10000000000000000000000000000000000000000000000000001
10000000000000000000000000000000000000000000000000001
11111111111111111111111111111111111111111111111111111


