SO ./cub3d.c     
        
WE  ./cub3d.c

EA ./cub3d.c

NO ./cub3d.c

F 220,100,0

C 220,100,50




1111111111111111111111
1000000011111110011
101000N0000011111111
1110000000011111
   1010000000001
   10100000000111111111111
    1111111110000000000001
             1111111111111111


